analysis: a detailed investigation of the parts of something
approach: a way of considering or doing something
area: a subject or specialization, or part of it
assessment: when you decide the value or quality of something
assume: accept something to be true without questioning it
authority: an expert on a subject
available: able to be used
achieve: to succeed in reaching a target or aim
acquisition: the process of getting something
administration: a method of managing the affairs of an organization
affect: to influence or cause something to change
appropriate: suitable or right for a particular purpose or situation
aspects: the parts of a problem, situation or task
assistance: an act of helping to complete a task
alternative: something different, or a choice of something else
access: the ability to get to or enter somewhere or something
adequate: enough or barely enough
annual: happening once a year
apparent: able to be understood, or seeming to exist
approximated: came near to, or estimated
attitudes: feelings or opinions about someone or something
attributed: indicated the cause of something
academic: relating to school, college, study or theory
adjustment: making small changes, or becoming suitable
alter: to change the form or character of something
amendment: a change made to the words of a text
aware: to have knowledge or be conscious of something
abstract: a written summary of the important points of a text
accurate: correct and without any mistakes
acknowledged: recognized, admitted the truth, or expressed thanks
aggregate: the total of all the parts
allocation: a share of something for a specific purpose
assigned: gave someone a task, or sorted something into groups
attached: added or fixed something to something else
author: writer
adaptation: modification to suit new conditions or environment
adults: people or living things that are fully grown or developed
advocate: to publicly recommend or support something
aid: to help or support
abandon: to leave forever, or to stop something in progress
accompanied: went or came with someone or something
accumulation: collection or process of collecting
ambiguous: not clear, or having two or more possible interpretations
appendix: supplementary material at the end of a book
appreciation: recognition of value, or expression of thanks
arbitrary: based on chance rather than reason
automatically: without need for help, or without thinking
accommodation: adjustment, agreement, or living place
analogous: similar or comparable in some ways
anticipated: expected something to happen
assurance: promise or confidence
attained: achieved or gained by effort
adjacent: next to, near, or touching
albeit: although, even though
assembly: a regular meeting of people, or putting parts together
