concept: an abstract or general idea
consistent: in agreement with expectations or other facts
constitutional: relating to the laws and principles of a government
context: the situation in which something exists or happens
contract: a legal agreement between people or groups
create: to make something new or invent something
categories: the groups by which something is classified
chapter: a part of a book or period of time
commission: a special group chosen to consider something
community: a social group of people who live in a particular area
complex: difficult to understand because of its many parts
computer: a machine which performs calculations automatically
conclusion: an opinion one reaches after careful consideration
conduct: to organize and perform a specific task
consequences: the undesired results of a particular act or situation
construction: the act of building something
consumer: a person who buys goods or services
credit: to recognize a person's contribution to a task
cultural: relating to the customs and beliefs of a certain group
circumstances: the conditions which make a situation the way it is
comments: spoken or written words to express an opinion
compensation: money received for the loss or damage of something
components: all the individual parts of a system or thing
consent: voluntary agreement or permission
considerable: large or of noticeable importance
constant: unchanging, or happening frequently
constraints: conditions that limit the freedom of a system or thing
contribution: money given or part played to achieve a group aim
convention: a conference, or the accepted way of doing something
coordination: movement of the body, or management of a group
core: the central or most important part of a system or thing
corporate: relating to a group, company or corporation
corresponding: similar to or anticipated
criteria: the rules or guidelines to test or evaluate something
civil: relating to the ordinary people of a country
code: regulations, or a set of symbols that mean something
commitment: willingness to spend time or energy on something
communication: the way living things send messages to each other
concentration: the ability to think or focus carefully about one thing
conference: a meeting or event with talks about a specific subject
contrast: an obvious difference between two or more things
cycle: a series of events which repeat in a predictable order
capacity: the maximum that can be contained or produced
challenge: something needing effort in order to be done well
clause: a group of words with a meaning, or a legal document
compounds: substances made up of two or more elements
conflict: fighting, or disagreement between people or ideas
consultation: a meeting to discuss something or seek advice
contact: communication, or when people or things touch
capable: having the ability or qualities to do something
cited: quoted as an example to support an argument
cooperative: willing to help, or involving joint activity
channel: a way through which something moves or is transmitted
chemical: a substance with a distinct molecular composition
classical: traditional, or belonging to ancient Rome or Greece
comprehensive: including many things or everything that is necessary
comprise: to include or consist of
confirmed: proved true, or made certain
contrary: not in agreement with, or opposite
converted: changed form, function or opinion
couple: to link together
chart: to watch carefully or record in detail
clarity: clearness of expression, thought, sound or image
conformity: agreement in form or opinion, or doing as others do
commodity: something that can be bought or sold
complement: to make better when combined
contemporary: existing now, or of the same period
contradiction: disagreement or incompatibility of two or more things
crucial: extremely important
currency: money or acceptance
ceases: stops something or comes to an end
coherence: logical consistency, or integration of parts
coincide: to happen at the same time, or be similar
commenced: started
concurrent: happening at the same time
confined: limited or enclosed
controversy: disagreement or argument about an important topic
conversely: in the opposite way, on the other hand
collapse: fall down or fail suddenly
colleagues: people who work or study together at the same place
compiled: put together from various sources
conceived: gave birth, imagined, or invented
convinced: persuaded or lead someone to believe or do something
