data: information from which conclusions may be drawn
definition: an explanation of a word or phrase
derived: formed or developed from something else
distribution: the way in which things or people are spread about
design: a plan of something or how its parts are arranged
distinction: a specific difference between two similar things
deduction: the act of finding a logical answer or opinion
demonstrate: to show or explain how something works
document: to record the details of a process or event
dominant: stronger than others of the same group or type
debate: a serious discussion involving many people
despite: without taking notice of or being influenced by
dimensions: aspects, or the length, width and height of something
domestic: relating to home or country
decline: to get weaker or diminish, or to refuse something
discretion: careful consideration for others, or the right to choose
draft: a piece of text or plan which is not in its final form
discrimination: biased and unfair treatment of a person or group
display: show, or arrange something to be seen
diversity: variety of opinions, styles, social groups or living things
domain: an area of interest, or an area controlled by someone
decades: periods of ten years, or a long time
definite: certain or clear
deny: to refuse, not admit, or say that something is not true
differentiation: the process of making something different
disposal: the process of getting rid of something
dynamic: relating to energy, motion, or change
denote: to indicate, or act as a symbol for
detected: noticed, or discovered using instruments
deviation: difference from the norm or what is usual or expected
displacement: movement of people or things away from a place
dramatic: exciting, outstanding, or very sudden
device: scheme or thing invented for a specific purpose
devoted: gave time or effort to a purpose, activity or person
diminished: made smaller in size or importance
distortion: change of shape, or inaccurate description or reporting
duration: period of time that something lasts
depression: unhappiness, or a period of little business activity
