economic: relating to money or trade
environment: the conditions one lives in and their effects
established: conventional or conforming to accepted standards
estimate: a guess of the size, number or amount of something
evidence: one or more reasons for believing something
export: to send goods to another country
elements: the basic principles of a subject of study
equation: a statement showing the equivalence of two things
evaluation: judgment of the value or quality of something
emphasis: the importance or special consideration of something
ensure: to make certain that something will happen
excluded: deliberately didn't include something
emerged: became known, or appeared out of something
error: mistake or wrong decision
ethnic: of a national, racial, religious or linguistic group
enable: to make something possible, practical or easy to do
energy: power or ability to be physically or mentally active
enforcement: to make or force something to happen or be accepted
entities: things, real or abstract, which exist independently
equivalent: being equal to or effectively the same as
evolution: a gradual process of change, or Darwin's theory
expansion: an increase in size of something
exposure: being affected by something in a particular place
external: relating to or existing outside
edition: a version or a batch of a publication in a series
enhanced: improved in quality, intensity, or value
estate: all of a person's property or wealth
exceed: to be more than a number, amount or allowed limit
expert: a person with great skill or knowledge of a subject
explicit: clear and detailed, not implicit
eliminate: to get rid of, remove, or leave out
empirical: based on observation or experiment
equipment: necessary items for a particular activity of purpose
extract: to get from source, pull out, or get by force
eventually: finally, or ultimately
exhibit: to show. display or reveal
exploitation: good use of resources, or unfair use of people
erosion: gradual weakening or damage caused by nature
ethical: morally right
encountered: met unexpectedly, or experienced something undesired
enormous: very big
