identified: recognized something by saying what it is
income: money earned by doing work or gained by investing
indicate: to show, point out, or make clear
individual: a single person or thing when compared to a group
interpretation: an explanation or opinion of what something means
involved: complicated or difficult to understand
issues: problems that people are thinking or talking about
impact: a powerful effect that something has on a situation
injury: damage to a person's body after an accident or attack
institute: an organization that does scientific or educational work
investment: the act of spending time or money in pursuit of gain
items: the things which are part of a list or group
illustrated: made clear with pictures or examples
immigration: the act of arriving at a country in order to live there
implies: suggests something without saying directly
initial: existing or occurring at the beginning
instance: an occurrence of something
interaction: communication, or the action of things on each other
implementation: the realization of a plan, idea or policy
implications: the possible consequences an event may bring
imposed: forced a rule, or made someone accept an idea
integration: to combine two or more things into a coherent whole
internal: relating to or existing inside
investigation: a detailed study of examination of a problem or crime
image: a picture in the mind or formed by a mirror or lens
ignored: gave no attention to someone or something
incentive: something that encourages or motivates a person to do
incidence: occurrence or rate of occurrence of something
incorporated: as a corporation, or combined into one thing
index: reference list arranged alphabetically, or scale
inhibition: the process of slowing down, restraining, or stopping
initiatives: introductory steps
input: contribution, or something that goes into a process
instructions: information about how to do something
intelligence: capacity to acquire and apply knowledge
interval: a short period of time between one event and the next
identical: the same in every way
ideology: system of beliefs or principles
inferred: conclude from evidence or logical thinking
innovation: invention or new idea or way of doing something
insert: to put something into something else
intervention: become involved in a situation in order to improve it
isolated: separated, or found the cause of something
implicit: understood without being said
induced: caused to happen, or persuaded to do
inevitably: as expected, or in a way that can not be avoided
infrastructure: basic organization of a system, or public services
inspection: careful or critical viewing or examination
intensity: strength of concentration of something
incompatible: unable to exist or work together effectively
inherent: existing as a natural and basic part of something
insights: discoveries or clear understandings of a complex issue
integral: necessary or important to complete a whole
intermediate: between two extremes or in the middle
inclination: slope, or the way a person feels about something
integrity: wholeness, honesty, or having principles
intrinsic: basic and essential, or by itself
invoked: used law or power to improve a situation
