percent: in proportion to a hundred
period: any length of time
policy: an established practice or plan of what to do
principal: the first, main, or most important
procedure: a course of action intended to achieve a result
process: a series of actions taken to achieve a result
participation: the act of taking part or being involved in something
perceived: saw, or generally recognized or believed to be true
positive: certain about something
potential: the capacity to develop, succeed or achieve
previous: occurring or existing before something or someone else
primary: more important than anything else
purchase: buy
partnership: a relationship involving close cooperation
philosophy: a system of beliefs that guide one's behavior
physical: of the body, or having material existence
proportion: the size of something when compared to the whole
published: made known to the public through writing
parallel: similar, or of equal distance apart along two lengths
parameters: the facts or rules which limit how something is done
phase: a period of time, especially as part of a series
predicted: said that something would happen in the future
principle: a basic truth or theory
prior: coming before something else in time or importance
professional: relating to or conforming to the standards of work
project: work or a study of a subject over a period of time
promote: to raise someone or something to a higher level
perspective: a way of looking at or considering something
precise: exact or careful and accurate
prime: the main or most important, or the best quality
psychology: study of how the mind works and affects behavior
pursue: to follow, try to get, or try to discover information
preceding: coming before something or someone else
presumption: an attitude based on probability rather than proof
paradigm: conceptual framework, or an example of something
phenomenon: something unusual or amazing which can be sensed
priority: something important that comes first or before others
prohibited: prevented, or refused to allow
publication: printed item such as a book, magazine or journal
paragraph: group of sentences which discuss a single topic
plus: and also, or more, added to
practitioners: people involved in an activity or job requiring skill
predominantly: mainly or mostly
prospect: anticipation, or probability of a favorable outcome
passive: accepting without resistance, or not active
portion: part or share of a whole
preliminary: prior to or in preparation for the main activity or event
protocol: set of rules and procedures
panel: a small group of people chosen to give their opinions
persistent: continuing for a long time, or refusing to give up
posed: asked formally, caused a problem, or stayed in position
