required: needed or made necessary
research: a detailed study of a subject
response: an answer or reaction to a question or statement
role: a function or part performed in a specific process
range: the upper and lower limits of something
region: a geographical or physical area
regulations: rules issued by an authority
relevant: correct or suitable for a particular purpose
resident: a person who lives at a particular place
resources: money, valuable possessions, or natural materials
restricted: with limitations, or available only to a select few
reaction: behavior or action as a result of a particular event
registered: recorded and accepted by a group or organization
reliance: the tendency to trust in someone or something
removed: took away
regime: a particular government or controlling group or system
resolution: a course of action which is decided purposefully
retained: kept or continued to have
ratio: a comparison of two things expressed as a number
rejected: refused to accept, make use of, or give affection to
revenue: income that a company or government receives
rational: logical or based on reason
recovery: return to normal, or getting back something lost
revealed: showed or made known
release: to let go or let out
reverse: opposite or back
radical: fundamental or extreme
random: without pattern or plan
reinforced: gave support to something
restore: to return to a previous condition or position
revision: a change of the words of a text
refine: improve something through small changes
relaxed: made rules or controls less severe
restraints: limitations or controls of the freedom of something
revolution: a sudden or important change in a situation
rigid: stiff and fixed, or not able to be changed or persuaded
route: way between places, or method of achieving something
reluctant: unwilling or hesitant
