section: a distinct part of something
sector: a geographic or economic area
significant: noticeable, meaningful or important
similar: almost but not exactly the same
source: the cause of something or place it comes from
specific: relating to one thing and not others
structure: the way parts of a system or object are arranged
security: protection of a person, property or organization
sought: simple past and past participle of seek
select: to choose, especially after careful consideration
site: a place where something was, is, or will be
strategies: detailed plans or methods for achieving success
survey: a series of questions used to gather personal data
scheme: an organized plan, or an outline of a system or thing
sequence: a series, or the order in which things are arranged
sex: the state of being either female or male
shift: a change in position, direction or conditions
specified: stated clearly or described accurately
sufficient: as much as is needed for a particular purpose
series: a sequence of similar or related things
statistics: a branch of applied mathematics that analyzes data
status: the relative position of someone or something
stress: to give emphasis or special attention to something
subsequent: happening after something else
sum: the total number or amount of things added together
summary: a short description of the main points of something
stability: resistance to change, or constancy of character
styles: types, expressions, or ways of doing something
substitution: the replacement of one thing by another
sustainable: able to be continued or maintained
symbolic: representing something else, or ineffective
scope: range covered, or opportunity
subsidiary: of lesser importance
simulation: model of the essential features of a process or thing
solely: only and exclusively
somewhat: slightly or rather
submitted: presented for consideration, or gave in to
successive: following in sequence and without a break
survive: to continue to live or exist
schedule: a plan of activities organized by time
scenario: imagined event, or model of expected outcomes
sphere: area of interest, knowledge or control
subordinate: of less importance or lower status
supplementary: extra, or supplying what is lacking
suspended: stopped something temporarily or permanently
so-called: commonly or falsely called
straightforward: easy to understand, or honest and frank
